"filename", "language", "Java", "Markdown", "HTML", "JSON", "comment", "blank", "total"
"c:\Users\polan\CodingBros\auebpath\src\main\java\com\auebproject\CodeToName.java", "Java", 54, 0, 0, 0, 0, 9, 63
"c:\Users\polan\CodingBros\auebpath\src\main\java\com\auebproject\DB.java", "Java", 36, 0, 0, 0, 23, 24, 83
"c:\Users\polan\CodingBros\auebpath\src\main\java\com\auebproject\Edge.java", "Java", 24, 0, 0, 0, 0, 7, 31
"c:\Users\polan\CodingBros\auebpath\src\main\java\com\auebproject\GeoJsonExporter.java", "Java", 103, 0, 0, 0, 8, 14, 125
"c:\Users\polan\CodingBros\auebpath\src\main\java\com\auebproject\GeoJsonToHtmlGenerator.java", "Java", 41, 0, 0, 0, 7, 12, 60
"c:\Users\polan\CodingBros\auebpath\src\main\java\com\auebproject\GeocodingService.java", "Java", 36, 0, 0, 0, 5, 7, 48
"c:\Users\polan\CodingBros\auebpath\src\main\java\com\auebproject\HtmlViewerAppSwing.java", "Java", 29, 0, 0, 0, 2, 8, 39
"c:\Users\polan\CodingBros\auebpath\src\main\java\com\auebproject\Input.java", "Java", 21, 0, 0, 0, 0, 3, 24
"c:\Users\polan\CodingBros\auebpath\src\main\java\com\auebproject\JSONtoString.java", "Java", 43, 0, 0, 0, 0, 5, 48
"c:\Users\polan\CodingBros\auebpath\src\main\java\com\auebproject\Location.java", "Java", 292, 0, 0, 0, 0, 62, 354
"c:\Users\polan\CodingBros\auebpath\src\main\java\com\auebproject\Main.java", "Java", 7, 0, 0, 0, 0, 3, 10
"c:\Users\polan\CodingBros\auebpath\src\main\java\com\auebproject\MapCreator.java", "Java", 73, 0, 0, 0, 9, 17, 99
"c:\Users\polan\CodingBros\auebpath\src\main\java\com\auebproject\Node.java", "Java", 24, 0, 0, 0, 0, 7, 31
"c:\Users\polan\CodingBros\auebpath\src\main\java\com\auebproject\NodeDistance.java", "Java", 9, 0, 0, 0, 0, 2, 11
"c:\Users\polan\CodingBros\auebpath\src\main\java\com\auebproject\NodeHandling.java", "Java", 86, 0, 0, 0, 1, 20, 107
"c:\Users\polan\CodingBros\auebpath\src\main\java\com\auebproject\OpenHtmlInBrowser.java", "Java", 13, 0, 0, 0, 0, 3, 16
"c:\Users\polan\CodingBros\auebpath\src\main\java\com\auebproject\ShortestPath.java", "Java", 119, 0, 0, 0, 14, 28, 161
"c:\Users\polan\CodingBros\auebpath\src\main\java\com\auebproject\UML.md", "Markdown", 0, 34, 0, 0, 0, 8, 42
"c:\Users\polan\CodingBros\auebpath\src\main\java\com\auebproject\Url.java", "Java", 36, 0, 0, 0, 6, 12, 54
"c:\Users\polan\CodingBros\auebpath\src\main\java\com\auebproject\User.java", "Java", 45, 0, 0, 0, 9, 17, 71
"c:\Users\polan\CodingBros\auebpath\src\main\java\com\auebproject\UserDAO.java", "Java", 140, 0, 0, 0, 41, 67, 248
"c:\Users\polan\CodingBros\auebpath\src\main\resources\data\athens_transport_data.geojson", "JSON", 0, 0, 0, 2524714, 0, 0, 2524714
"c:\Users\polan\CodingBros\auebpath\src\main\resources\data\athens_transport_data3.geojson", "JSON", 0, 0, 0, 4632891, 0, 0, 4632891
"c:\Users\polan\CodingBros\auebpath\src\main\resources\data\exported_data.geojson", "JSON", 0, 0, 0, 1, 0, 0, 1
"c:\Users\polan\CodingBros\auebpath\src\main\resources\web\MapViewer.html", "HTML", 0, 0, 22, 0, 0, 3, 25
"Total", "-", 1231, 34, 22, 7157606, 125, 338, 7159356